REP = "countries/Galactic Republic.txt"
CIS = "countries/Confederacy of Independent Systems.txt"
MAN = "countries/Neutral Systems.txt"
HTT = "countries/Hutt Council.txt"
CHS = "countries/Chiss Ascendancy.txt"
TCU = "countries/Techno Union.txt"
TDF = "countries/Trade Federation.txt"
DKJ = "countries/Desilijic Kajidic.txt"
BKJ = "countries/Besadii Kajidic.txt"
GKJ = "countries/Gorensla Kajidic.txt"
QKJ = "countries/Qunalaac Kajidic.txt"
NOB = "countries/The Noble Court.txt"
ZGY = "countries/Zygerrian Empire.txt"
KAS = "countries/Kashyyyk.txt"
TOY = "countries/Toydaria.txt"
ORC = "countries/Outer Rim Commonwealth.txt"
YIN = "countries/Yinchorri.txt"
BES = "countries/Bespin.txt"
BLS = "countries/Black Sun.txt"
CSA = "countries/Corporate Sector Authority.txt"
DWA = "countries/Death Watch.txt" 
EOT = "countries/Empire of the Hand.txt"
GNG = "countries/Gungans.txt"
LKR = "countries/Lok Revenants.txt"
MNC = "countries/Mon Calamari.txt"
OHN = "countries/Ohnaka Gang.txt"
OND = "countries/Onderon Rebels.txt"
RNB = "countries/Royal Naboo.txt"
SAB = "countries/Sabaoth Squadron.txt"
SCC = "countries/Stark Commerical Combine.txt"
SHA = "countries/Shadow Collective.txt"
VNG = "countries/Yuuzhan Vong.txt"
ZAN = "countries/Zann Consortium.txt"


